99 99
///////////////////////////////////////////////////////////////////////////////////////////////////
/0----/-----------/---/---/---/---/---/---/---/-------/-/---------/---------/-----------/---------/
/-///-///-///////-/-/-/-/-/-/-/-/-/-/-/-/-/-/-/-/////-/-/-/////-/-/-///-///-/-/////-///-/-/-/////-/
/-/-------/---/---/-/---/---/---/---/---/---/---/---/-/-------/-/-/-/---/---/-/---/-/-/-/-/-/-----/
/-/////////-/-/-///-/////////////////////////////-///-/-///////-/-///-///-///-/-/-/-/-/-/-/-///////
/-------/---/-/---/---/---------/-----/-------/-------/-/-------/-----/-/-/-/---/-/-/---/-/-------/
///////-/-///-///-/-/-/-///////-///-/-/-///-/-/-/////////-/////////////-/-/-/////-/-///-/-///////-/
/-----/-/-/-/-----/-/-/-------/-----/-/-/---/-/---/-------/---/---------/-/---/---/---/-/-/-------/
/-///-///-/-/////////-/-/////-///////-/-/-///-///-/-///-///-/-/-/////-///-/-///-/////-/-///-/////-/
/---/---/---/-/-------/-/---/-------/-/-/-/---/---/---/-/---/-/-/---/-----/---------/-/-----/---/-/
///-///-///-/-/-/-/////-/-/-///////-///-/-///-/-///-///-/-///-/-/-/-/////////-///////-///////-///-/
/---/-/-/---/---/-/---/---/-----/-/-----/---/-/---/-/---/-/-/---/-/---/-----/-/-------/-------/---/
/-///-/-/-///////-/-/-/////////-/-/////////-/-///-///-///-/-///////-/-/-///-///-///////////-///-///
/---/-/-/---/-----/-/-------/---/-------/-/-/-/---/---/---/---/-----/-/---/-----/-----/-----/---/-/
///-/-/-///-/-///////-///-///-///-/////-/-/-///-///-///-///-///-/-///-///-/////////-/-/-/-///-///-/
/---/---/---/-/-----/---/-/---/---/-/---/-/-/---/---/-/---/-/---/-/---/---/-------/-/-/-/-/---/---/
/-///-///-///-/-///-///-///-/////-/-/-///-/-/-///-///-///-/-/-///-/-///-///-///-/-/-/-/-///-///-/-/
/---/-/-/-/---/---/-----/---/-----/---/---/---/---/-------/---/-/-/---/---/-/---/-/-/---/---/---/-/
///-/-/-/-/-///-/-///////-///-/////-/////-/////-///////-/////-/-/-///-///-///-///-/-/-///-///-/-///
/---/---/-/---/-/-------/---/-/-----/-------/---------/-----/-/-/---/-----/---/-/---/-/---/---/---/
/-///-///-/-/-/////////-///-/-///-///-///////-///////-/////-/-/-///-///////-///-/////-/-///-/////-/
/-/---/---/-/-------/---/---/---/-/-/---------/-------/-/---/-----/-/-/-------/-------/-/-------/-/
/-/-///-///-///////-/-///-///-/-/-/-/-/////////-///////-/-/////////-/-/-/////-///////-/-/-///////-/
/-/-/---/-------/---/---/---/-/-/-/-----/-------/-----/---/---------/-/-/---/-------/-/-/-/-------/
/-///-///-///////-///-/-///-///-/-///////-///////-/-///-///-/-///////-/-/-/////////-///-///-/////-/
/-----/---/---/---/---/-----/---/-/-------/-------/-/---/---/-/---/-----/---------/-----/---/---/-/
/-/////////-/-/-///-/////////-///-/-/////////-/////-/-///////-///-/-/////////-///-///////-///-///-/
/-/---------/---/---/-------/---/---/---------/-/---/---/-----/---/-/---------/---/-/-------/-/---/
/-///-///////////-/////-///-///-///////-///////-/-/////-/-/////-///-///-///////-///-/-/////-/-/-///
/-----/-------/---/-----/---/---/-------/---/-------/---/-/-/---/---/---/---/---/---/---/---/-/---/
///////-///-///-/////-///-///-///////-///-///-///////-///-/-/-/-/-///-///-///-///-///-///-///-///-/
/-----/-/---/---/-----/---/---/-------/---/---/---/---/---/---/-/---/-/---/---/-------/---/---/---/
/-/-/-///-/-/-///-/-///-///-///-///////-///-///-///-///-///-///-///-/-/-/-/-///-///////-/////-/-///
/-/-/-----/-/-/---/-/---/---/-/-------/---------/---/---/---/-/-----/-/-/-----/-/-------/-----/-/-/
///-///////-/-/-///-/-///-///-/-/////-///////-///-///-///-///-///////-///////-///-///////-///-/-/-/
/---/---/---/-/-/-/-/-----/---/---/-/-------/-/---/---/---/---------/-------/-----/-/-------/-/-/-/
/-///-/-/-///-/-/-/-///////-/////-/-///////-///-///-///-/////-/-/////-/////-///////-/-/////-///-/-/
/---/-/---/---/---/-----/-------/-/-----/-/-----/---/-------/-/---------/---/-------/-/---/-----/-/
///-/-/////-///-///////-/-///-///-/-///-/-///////-/////////-/-///////////-///-///-///-/-/////////-/
/---/---/---/---/-------/-/-/-----/---/-/-------/-------/---/-/---/---/---/---/-/-----/-----------/
/-///-///-///////-///////-/-///////-/-/-/-/////-///////-/-///-/-///-/-/-///-///-///////-/-///////-/
/---/-/---/-------/-------/-------/-/-/---/-/---/-------/-/-----/---/---/-/---/-------/-/-------/-/
///-/-/-///-///////-///////-/////-/-/-/////-/-///-///////-///////-///////-///-/-///-///-///////-/-/
/---/-/-/-----/-/---/-------/-/---/-/-----/---/---/-----/-/---/---/---/---/---/-/-/-----/---/---/-/
/-///-/-/-///-/-/-/////-/////-/-/////////-/-///-/////-///-/-/-/-///-///-/-/-///-/-///////-///-///-/
/---/-/-/-/---/---/-----/-----/-/---------/-/---/-----/---/-/---/---/---/-/---/-----------/---/-/-/
/-/-///-///-///-///-///////-/-/-///-///////-/-///-/-///-///-/////-/-/-///-///-/////-///////-///-/-/
/-/-----/---/---/---/-------/-/-/---/-----/---/---/-/---/---/---/-/---/-/-----/-----/-------/-/---/
/-///////-///-///-/////-///-///-/-///-///////////-///-/////-/-/-/-/////-/////////////-///////-/-///
/-/-------/---/-----/---/---/---/-/---------------/---/---/-/-/-/-/---------/---------/-------/---/
/-/-///////-///////-/-///-///-///-///-/////-///////-///-/-/-/-///-///-/////-/-/-///////-/////-///-/
/---/-------/-------/---/-/---/-----/---/-/-------/---/-/---/-/---/---/-/---/-/-/-------/-----/---/
/////-///////-///////-/-///-///-///-///-/-///////-///-/-/////-/-///-///-/-///-/-///-///-///////-///
/-/---/-------/-----/-/-----/---/---/---/---/---/-----/---/---/---/-/---/---/-/---/-/-/-------/---/
/-/-///-///////-/-///-///////////-///-///-///-/-///////-/-/-/-///-/-/-/-///-/-///-/-/-///////-///-/
/-/-/---/-----/-/-----/---/---/---/-/---/-/---/---------/-/-/-/---/-/-/-/---/---/-/-------/-/-----/
/-/-/-///-///-/-///////-/-/-/-/-///-///-/-/-/////////////-/-/-/-///-/-///-///////-///////-/-///////
/-/-/---/---/---/-------/---/---/---/---/---------/-------/-/-/-/---/-------/-----/---/---/-------/
/-/-/-/-///////-/-///////////////-///-///-/////////-///////-/-/-/-/-///////-/-/////-/-/-///-/-/////
/---/-/-------/---/-----/---/-----/---/-----/-------/-------/-/-/-/-------/-/-/-/---/-/---/-/-----/
/-///-///////-///////-///-/-/-///-/-/////////-///////-/////-///-/-///////-/-/-/-/-///-///-/-/////-/
/-/-------/---/-------/---/---/-/---/---------/-----/-/---/-----/-/-------/---/---/-/-----/-/---/-/
/-/-///////-///-/-/////-///////-/////-/////////-/-///-/-/-/////////-///////////-///-/////////-/-/-/
/-/-/---/---/---/-/---/---/---------/-----/-----/-----/-/-/---------/-----/---/-/-/-----------/---/
/-///-/-/-///-/////-/-///-/-/-/////-/-///-/-///////////-/-///////-/////-///-/-/-/-/-/-///////////-/
/-----/---/---------/-/---/-/-/---/-/-/---/-------/---/-/-/---/---/-----/---/---/---/---/-/---/---/
///////////-/////////-/-///-/-/-/-/-///-/////////-/-/-/-/-/-/-/-///-/////-///////-/////-/-/-/-/-///
/---/-----/---/-------/---/-/-/-/---/---/-----/---/-/---/---/---/-------/---/---------/-/---/---/-/
/-///-/-/-/////-/////-///-/-/-///-///-///-/-///-///-///////////////////-///-/-/////////-/-///////-/
/-/---/-/-------/---/-/---/-/---/-/---/-/-/-/---/-----/---------/-------/---/---/-------/---/-----/
/-/-///-/////////-///-/-///-///-/-/-///-/-/-/-///////-/-///////-/-///-///-///////-/////////-/-///-/
/---/-/-------/-------/-/-----/-/-/-/-/---/---/-------/-----/-/-/---/-/---/-------/-----/---/-/---/
/-///-///////-///////-/-///////-/-/-/-/-///////-///////////-/-/-/-/-///-///-///////-/-///-///-/////
/-----/-----/-------/-/-/-------/-/-/---/-------/-----------/---/-/-/---/---/-----/-/-/---/-------/
/////-/-///-///////-///-/-///////-/-/-///-///////-///-///////-/////-/-///-/////-/-/-/-/-///-/////-/
/-/---/---/-------/-----/-/-----/---/---/-------/---/-------/-------/-/-------/-/---/---/-------/-/
/-/-/////-///////-///////-/////-///////-/-/////-///////-///-///////-/-/-/////-/////-/////-///////-/
/---/-------/---/-------/-----/-----/---/-----/-------/-/-/-------/-/-/-/---/-----/-----/---/-----/
/-///////////-/-/-/////-/////-/-///-/-///////-///////-/-/-///////-///-/-///-/////-/////-/-///-///-/
/-/---/-------/---/---/-/-----/---/-/-/-/---------/---/-/-------/-----/-----/---/-/---/-/-/---/-/-/
/-/-/-/-///////////-///-/-///////-/-/-/-/-/////////-///-/-/////-/////////////-/-/-/-///-///-///-/-/
/---/---/---------/-----/-/-------/-/-/-/---/---/---/-/---/-----/-------------/---/-/---/---/-----/
/////////-///-/////-/////-///-///-///-/-/-///-/-/-///-/////-///////////-///////////-/-///-///////-/
/-------/---/-----/---/---/---/---/---/---/---/---/-------/-/---/-------/---------/---/-/-------/-/
/-///-/-///-/////-///-/-///-///-///-///-///-///////-/-/////-/-/-/-///////-/////-///-///-/-/////-/-/
/-/-/-/-/---/---/---/-/---/---/-/---/---/---/-----/-/---/---/-/---/-----/-/---/-----/-------/---/-/
/-/-/-///-///-/-/-///-///-/-/-///-///////-/////-///-///-/-///-/////-/-///-/-/////////////////-///-/
/-/-/-/---/---/-/-----/---/-/-----/-------/-----/---/-/-/---/---/-/-/-----/-----------/---/---/---/
/-/-/-/-///-/-/////////-///-///////-/////////-///-///-/-///-/-/-/-/-///////////////-/-/-/-/-///-///
/---/---/---/---------/-/-/---/-----/---/-----/---/---/-----/-/-/-/---/-----/-------/---/---/-/---/
///-/////-///////-///-/-/-///-///-///-///-/-/-/-///-/-///////-/-/-///-/-/-/-/-///////////////-///-/
/-/-----/-/-------/---/-/-------/-/---/---/-/-/---/-/-/-----/-/-/-----/-/-/---/-------------/-/---/
/-/////-///-///////-///-///////-/-/-///-///-/-///-/-/-/-///-/-/-///-///-/-/////-/-/////////-/-/-///
/---/---/---/---/---/---------/---/-/---/-/-/-/---/-/---/---/-/---/---/-/---/---/-----/-------/-/2/
/-///-///-///-///-///-///////-/////-/-///-/-///-///-/////-///-///-///-/-///-/-///////-///////-/-/1/
/---/---/---/-/---/---/-------/-----/---/-/---/-/-----/-/---/---/-/---/---/-/-/-----/-------/-/-/-/
/-/-///-///-/-/-///////-///////-///-///-/-///-/-/////-/-///-/////-/-///////-/-/////-///////-///-/-/
/-/---------/-----------/---------/---------/---------/-----------/---------/-------------/-------/
///////////////////////////////////////////////////////////////////////////////////////////////////
