149 149
/////////////////////////////////////////////////////////////////////////////////////////////////////////////////////////////////////////////////////
/0------/-----/---/---/---------/-----------/---------/---/---/-------/-----------/-------------/-------/-----/---/---/---------/-----------/-------/
/-/-///-/-///-/-///-/-/-/-/////-/-/////////-/-/////-/-/-/-/-/-/-/////-/-/////////-/-/////-/////-/-/////-/-///-/-/-/-/-/-///////-///-///////-///-/////
/-/-/-----/-----/---/-/-/-/-/---/---/-------/---/---/---/---/---/---/-/---/---/---/-/---/-/-/---/-/-----/---/---/---/---/-/-----/---/---/---/---/---/
/-/-/////////////-///-/-/-/-/-///-/-/-///////////-///////////////-///-/-/-/-///-/////-/-/-/-/-///-/-///////-/////////////-/-/////-///-///-///-///-/-/
/-/---/---/-------/---/-/-/-----/-/-/-/---/---/---/---/-------/-------/-/-/---/---/---/---/-/-/---/-/-----/-/---/---------/-/-----/-----/---/-/---/-/
/-///-/-/-/-///////-///-/-/////-///-/-/-/-/-/-/-/////-/-///-/-/-/////////-///-///-/-///////-/-/-///-///-/-/-///-/-/////-///-/-/-///////-///-/-/-///-/
/-/-/-/-/---/-----/-/---/---/---/---/---/---/---/-----/-/---/-/---/-------/---/---/---/-----/-/---/-----/---/---/-/---/-----/-/-------/-/---/---/---/
/-/-/-///////-///-/-/-/////-/-///-///////////////-///-/-/-///-///-/-/-/////-///-/////-/-/-///-///-///////////-///-///-///////-///////-/-/-///-///-/-/
/-/-/-----/-----/-/-/-----/-/-/---/---------/-------/-/-/-/---/---/-/-----/-/---/-----/-/-/---/---/-----------/---/---------/-/---/---/-/-/---/---/-/
/-/-/////-/-///-///-///////-/-///-/-/-/////-/-/////-///-/-///-/-/////////-/-/-///-/////-/-/-///-///-///////-/-/-///-///-/////-/-///-///-/-/////-///-/
/-------/-/---/-----/-------/-/---/-/-----/-/-/---/-----/---/-/---/-------/---/---/-----/-/---/---/-/-----/-/-/---/-/---/-------/---/---/-/-----/---/
///////-/-///-///////-///////-/-///-/////-///-/-/-/////////-/-///-/-///////-///-/////-/-/////-///-/-/-///-/-/////-/-/////-///////-///-///-/-/////-///
/-----/-/-----/-------/-/-----/---/-----/-----/-/-/-------/-/-/---/-/-----/---/-----/-/-------/---/---/---/---/---/-------/-------/-/-----/-/---/---/
/-/-///-///////-///////-/-/////-/-///////-/////-/-///////-/-///-///-///-/////-/-///-///////-///-///////-/////-/-///-///////-///////-/-/////-///-///-/
/-/-/---/-------/-------/-/---/-/-------/-/---/-/-/---/---/-/---/-----/-----/-/-/-/-------/-----/---/---/---/-/---/-/-------/-/-------/-----/---/---/
/-/-/-///-///////-///-///-/-///-///////-/-/-/-/-/-/-/-/-/-/-/-///////-/-/-///-/-/-///////-/////////-/-///-/-/-///-///-///////-/-///////-/////-///-///
/-/-/-/---/-----/---/-----/---------/---/---/---/---/---/-/---/-------/-/-----/---------/-------/---/-/---/-/-----/---/---/-----/-----/-/-------/---/
///-/-/-///-///-///-///////-/////////-///////////////////-///////-/////-///////////-///////////-/-/-/-///-/////////-///-/-/-/////-/-/-/-/-/////-///-/
/---/-/---/---/-----/---------/---/---/---/-------------/-/-------/---/-----/-----/-/---/-------/-/-/-/---/-----/---/---/---/---/-/-/---/-/---/-----/
/-///-///-///-/////////-///////-/-/-///-/-/-///-///////-/-/-///////-///////-/-/-/-///-/-/-///////-///-/-///-/-/-/-///-/////////-/-/-/////-/-/-///////
/-/---/---/---/-------/-/-------/---/-/-/-/-/-/-------/-/-/-------/-/-------/-/-/-----/---/-------/---/-----/-/---/---/-------/-/-/---/---/-/---/---/
/-/-///-///-///////-/-///-///////////-/-/-/-/-///////-///-/-/////-/-/-/////////-///////////////-/-/-/////////-/////-/////-///-/-/-///-/-///-///-/-///
/---/---/---/-----/-/-----/-----/---/---/---/-----/-/-----/---/---/---/-/-------/-/-------------/-/-/---------/-/---/---/-/---/-/-/-/-/-/---/-/-/---/
/-///-///-///-/-/-/-///////-/-///-/-/-///////-///-/-///////-///-///-///-/-/-/////-/-/////-///////-/-///-///////-/-///-/-/-/-///-/-/-/-/-///-/-/-///-/
/-----/---/---/-/---/-----/-/-/---/---/-------/---/---------/---/-/---/---/-/-----/-/---/-------/-/-/---/-/---/---/---/---/-/-/---/-/-/---/-/---/---/
///////-///////-/////-///-/-///-///////-/-///////-///////////-///-///-/////-/-/-///-/-/////////-///-/-///-/-/-/-///-/-/////-/-/-///-/-///-/-/-///-///
/---/---/-------/---/-/-/-/---/-/-/---/-/-------/-/---/-------/-----/-/-----/-/-----/---------/-----/-/-/---/---/---/---/-/-/---/---/---/---/---/---/
/-/-/-///-///////-/-/-/-/-///-/-/-/-/-/-///////-/-/-/-/-///////-/-///-/-/////-///////////////-///////-/-/-/////////-///-/-/-/-///-/////-///////-///-/
/-/---/-----/-----/---/---/---/-/---/-------/---/---/---/-------/-/---/-/-----/---/---/---/-----/---/-/-/---/-----/---/-/---/-/---/---/-/---/---/---/
/-/////-///-/-/////////-///-///-/-///////////-/////////////-/////-/-///-/-/////-/-/-/-/-/-/-///-/-/-/-/-///-/-///-/////-/-///-/-/-/-/-/-/-///-///-/-/
/-----/-/---/---/-----/-/---/---/-----/---/---/-------------/-/---/---/-/-------/---/---/---/-/---/---/-/---/-/---/-----/-/-/---/-/-/---/---/-/---/-/
/////-///-///-/-/-/////-/-///-/////-///-/-/-/////////-///////-/-/////-/-/////////////////////-/////////-/-///-/-///-/////-/-/////-/-///////-/-/-///-/
/-/---/---/---/-/---/-----/---/-----/---/---/---------/-/-----/---/---/-----/-/-------------/-----/-----/---/-/---/-/---/-/-----/-/---/-----/-/-/---/
/-/-///-///////-///-/-/////-/////////-/////////-///////-/-/-/////-/-///////-/-/-///-///////-///-/-/-/-/-///-/-///-/-/-///-/-/////-///-/-/-///-/-/////
/-/-/---/-------/---/-/-/---/-----/---/---------/---------/---/---/---/-----/---/-/-------/-----/-/-/-/-/---/-/-----/-----/---------/-/-/-----/-----/
/-/-/-///-///////-///-/-/-/////-/-/-///-/////-///////-///////-/-/////-/-/////-///-///////-///////-///-/-/-///-///////-/////-/////////-/-///////////-/
/-/-/-/-/-------/-------/-/-----/---/-----/---/-----/-------/-/---/---/-/---/-/---------/-------/-----/-/-/-------/-/---/-----/-------/-/-------/---/
/-/-/-/-/-/////-///////-/-/-/////////-///-/-///-///-///////-/-///-/-///-///-/-/-/////-/////////-///////-/-/-/////-/-///-///////-///////-/-/-///-/-/-/
/---/-/---/---/-------/-/-/-/-------/-/-/-/---/---/-------/-/-----/-/---/---/-/-/---/---------/-------/-/-/---/---/---/-/-------/-/---/-/-/---/---/-/
/-///-/-/////-///////-///-/-/-///-///-/-/-///-///-///////-///////-/-/-///-///-/-/-///////-///-///////-///-/-///-///-///-/-///////-/-/-/-/-///-/////-/
/-/---/---/---/-----/-----/-/---/-----/-/-/---/---/-----/-------/-/-/---/-----/---/-------/---/---/-/-----/-/---/-/-----/-------/---/---/---/-/---/-/
/-/-/////-/-/-/-///-///////-///-///////-/-///-/-///-///-///////-///-///-/-/////////-///////-///-/-/-/////////-///-/-/////-/////-/////-///////-/-/-/-/
/-/---/---/-/---/-/---/-------/-------/-/---/-/---/-/---------/-----/---/---/-------/-------/---/-----/-------/---/---/---/---/-----/-/-------/-/-/-/
/-///-/-///-/////-///-/-/////-///////-/-///-/-///-///-///////-///////-/////-/-///////-///////-///////-/-///////-/-///-/-/////-/////-/-///-/////-///-/
/-----/---/-/---------/-/---/-------/-----/-/-/---/---/-------/-----------/---/-------/-----/-/-----/---/-/-----/-----/---/---/---/-/-----/-----/---/
/////////-/-///////-///-///-///////-/////-/-///-///-///-/////////////////-/////-///////-///-/-/-/-///////-/-/////////////-/-///-/-/-///////-/-///-///
/-/-------/-------/---/-----------/-----/-/-/---/---/---/---/-----/-------/-/---/-----/---/-/-/-/-/---/-----/-------/-/-----/---/---/-------/-/---/-/
/-/-/////////////-///-///////////-/////-/-/-/-///-///-///-/-///-/-/-///////-/-///-/-/-///-/-/-/-/-/-/-/-///////-///-/-/-/////-///////-/////-///-///-/
/---/-----/-------/---/---/-------/---/-/-/---/---/---/---/-----/---/-----/---/---/-/-----/---/-/---/---/-------/-/-/-----/---/-----/-/---/-----/---/
/-/////-/-/-///////-///-/-/-///////-/-/-/-/////-///-/////-/////////////-///-///-///-///////////-/////////-///////-/-///////-///-/-///-/-/-///////-///
/-/-----/---/---/---/---/---/-------/---/-----/---/-/---/-/---------/---/---/---/-/-/---------/-/---/-------/-------/-------/-/-/-----/-/---/-/-----/
/-///-///////-/-/-///////////-///////////////-///-/-/-/-/-/////-///-/-/-/-///-///-/-///-///-///-///-/-/////-///////-/-///////-/-///////-///-/-/-///-/
/-/---/---/---/---/---/-------/---/-------/---/---/---/---/-----/---/-/-/---/---/-/---/---/-/---/---/-----/-------/---/-----/-/---/-----/---/---/---/
/-/-///-///-///////-/-/-///////-///-///-///-///-///////////-/////-///-/-///-///-/-///-///-/-/-///-///-///////////-/////-///-/-///-/-/////-///-///-/-/
/---/---/---/-----/-/---/-------/---/-/-/---/---/-----------/---------/-/---/---/---/-/---/-/---/-/---/---/-------/---/---/-/-/---/-/-/---/---/---/-/
/////-/-/-///-///-/-///////-/-///-///-/-/-///-///-///////-/////////////-/-///-/////-/-/-///-///-/-/-///-/-/-///////-///-/-/-/-/-///-/-/-///-///-///-/
/-/---/---/---/---/---/-----/-/---/---/---/---/---/-----/-------/-------/-/-/---/---/-/---/-/---/---/---/---/-------/---/-/---/---/-/-----/-/---/-/-/
/-/-///////-///-///-/-///-/-///-///-///////-///-/////-/-///////-///////-/-/-///-/-///-///-///-///////-///////-///-///-///-///-///-/-/////-///-///-/-/
/---/-------/-/---/-/-/---/-/---/-----------/-/---/---/-/-----/-------/-/-/-/---/---/---/-/---/---/---/-------/---/---/-/-/---/---/-----/-----/---/-/
/-///-///////-///-/-/-/-/////-///-///////-///-///-/-///-/-/-/-///////-///-/-/-/////-///-/-/-///-/-/-///////-///-///-///-/-///-/-///-///-///////-///-/
/-/---/-------/---/-/-/---/---/---/-------/-/-----/---/-/-/-/-------/-----/-----------/-/---/---/---/-------/-/-/-/-/---/---/-/---/-/-/-------/-----/
/-/-///-/-///-/-///-/-///-/-///////-///////-/-///////-/-///-///////-///////////-///////-/-/////-/////-///////-/-/-/-/-/-///-/-///-/-/-///////-/-/////
/-/---/-/---/-/---/-/---/-/-/-------/---/-----/-------/-----/---/---/---/-----/-/-------/-----/---/---/---/-------/-/-/---/-/-/---/-------/---/---/-/
/-///-/-///-/-///-/-///-/-/-/-/-/////-/-/-///////-///////////-///-///-/-/-/-/-///-///////////-/-/-/-///-/-/-///////-/-///-/-///-///-///////-/////-/-/
/-----/---/-/-/---/---/-/-/-/-/-/-/---/---/-------/---/-------/---/---/-/-/-/-----/---/---/---/-/-/---/-/-------/---/-/---/-/---/---/---/---/-----/-/
/////////-/-///-///////-/-/-/-/-/-/-///////-///////-///-/////-/-/////-/-///-///////-///-/-/-///-/-/-/-///////-///-///-/-///-/-///////-/-/-///-/////-/
/-------/-/-/---/-------/---/-/-/---/-------/---/---/---/---/---/-----/-----/---/---/---/-/---/-/-/-/-------/-/---/---/---/---/-------/---/-/-/-----/
/-///-///-/-/-///-///////-///-/-///-/-///////-/-/-/-/-///-/////////-/////////-///-/-/-///-///-/-/-///////-/-///-///-/////-/////-///////////-/-/-/-/-/
/---/-/---/---/---/-----/-/---/---/---/-------/---/-/-/-/-----/-----/---------/---/---/-/-----/-/---/---/-/-----/---/---/---/---/-/---/-------/-/-/-/
///-/-/-///////-///-///-/-/-/////-/////-///////////-/-/-/-/-/-///-///////-/-///-///////-///////-///-/-/-/-///////-///-/-///-/-///-/-/-/-/////////-/-/
/---/-/-/-----/---/---/-/-/-----/-/-----/---/---/---/-/---/-/-----/-------/-/---/-----/-------/---/---/-/-/-------/---/-/---/-/-----/---/---------/-/
/-///-/-/-///-///-/-/-///-///////-/-/////-///-/-/-///-/////-///////-/////-///-///-/-/-/-/////-/-///////-/-/-///////-/-///-///-/-///////////-///////-/
/---/-/-/-/-------/-/-----/-------/-/-----/---/---/---/-----/-------/-----/---/---/-/---/-/---/-/-------/---/---/---/-/---/---/-/-------/---/-----/-/
///-///-/-/////////-///////-///////-///-/-/-///////-///-///////-/////-/////-///////-/////-/-/////-///////////-/-/-///-/-///-///-/-/////-/-///-///-/-/
/---/---/-------/-----------/-------/---/-/-----/---/---/-------/-/---/-/---/-------/-----/---/---/-------/-/-/-/---/---/-----/---/---/-/---/---/---/
/-///-///-/////-/////////////-///////-///-///-///-/////-/-///////-/-///-/-///-/////////-/-///-/-///////-/-/-/-/-///-/////-///-/////-///-/-/-///////-/
/---/---/-----/-------/---/-----/-------/-/---/---/-----/-------/-------/-/-----/-------/-/---/---/-----/-/---/-/---/-----/-/-/-----/---/-/-------/-/
/-/-///-/-///////////-/-/-/-///-///////-///-///-///-/////-/////-///////-/-/-///-/-///////-/-/////-/-/////-/-///-/-///-/////-/-/-/////-///-///////-/-/
/-/-----/-/---/-------/-/-/---/-------/-------/-/---/---/-/---/-------/-/-/-/---/-/-----/-/---/---/-/-----/-/---/---/-/-----/-/-----/---/-----/---/-/
/-/////////-/-/-///////-/-///-///////-///////-/-///-/-///-/-/-///////-///-///-///-///-/-/-///-/-///-///-/////-/-///-/-///-/-/-/////-///-///////-///-/
/-----/-----/---/-/---/-/-----/-----/-------/-/-/---/-/---/-/-/-----/-----/---/-----/-/---/---/-/-----/-------/-/---/-----/-/-----/-----/---/---/---/
/////-/-/////////-/-/-/-///////-///-///////-///-/-///-/-///-/-/////-///////-///////-///////-///-/-///-///////-///-///////-///////-/-/////-/-/-///-///
/-----/-/-/-----/---/---/-----/-/-/-/-----/-----/---/-/-/---/---/-------/-/-------/-------/-/---/---/-------/-/---/-------/-------/-/-----/---/---/-/
/-/////-/-/-///-/-/////////-/-/-/-/-/-/-///////////-/-/-/-/-///-/-/////-/-/-/////-///////-/-/-/////-///////-///-///-///////-///////-///-///////-///-/
/-/-----/-/---/-/-/-/-------/---/---/-/-------------/-/-/-/---/---/---/-/---/---/-------/-/-/-----/-----/---/---/---/-------/-/-----/---/---/---/---/
/-/-/////-///-/-/-/-/-///-///////-///-///////-///////-/-/-///-/////-///-/-/////-///////-/-/-/-///-///////-/-/-///////-///////-/-/////-///-/-/-///-/-/
/-/-/-----/---/---/---/---/-/---/-/-------/---/---/-----/---/-/-----/---/-/---/-----/---/---/-/-/-------/-/-/-/-------/-------/-/-----/---/---/---/-/
/-/-/-/////-///////////-///-/-/-/-/-///////-/////-/-/////////-///-/-/-///-/-/-/-/-///-///-///-/-///////-/-/-/-/-///////-///-///-/-/////-/////////-/-/
/---/-----/---/---------/-----/---/-/---/---/-----/-/---------/---/-/-/-----/---/-/---/-/-/-/-------/---/-/-/-/-/-----/---/-----/---/---------/---/-/
/////-///-///-/-/////////-///////////-/-/-///-/-///-///-///////-///-/-/-///////////-///-/-/-/-///////-///-///-/-/////-///-///////-/-/////////-/-///-/
/---/-/-/-----/---/-/---/-/---/-------/---/---/-----/---/-/-------/-/-/-/---/-------/-/---/---/---/---/-/-----/-----/---------/---/-------/-----/-/-/
/-/-/-/-/////////-/-/-/-/-/-/-/-///-///////-/////////-///-/-/////-///-/-/-/-/-///////-/-///-///-/-/-///-/-/////-///-/////////-/-/////////-///////-/-/
/-/-/-/-----/---/-/---/---/-/---/---/-/---/-/-----/---/---/-/---/-----/-/-/---/-/-----/-/---/---/---/---/-/-/---/-/-------/---/-/-------/-------/-/-/
/-///-/-/-/-/-/-/-/-/////////////-///-/-/-/-/-///-///-/-///-/-/-///////-/-/////-/-///-/-/-///-/////////-/-/-/-///-///////-/-///-///-///-///////-/-/-/
/-----/-/-/---/---/-/-----/-------/-----/---/---/-----/-----/-/-------/-/---/---/-/-/---/-/---/---------/-/---/-------/---/---/-----/-/-----/---/---/
/-///////-/////////-/-///-/-///////-///////////-///////-/////-/////-/-/-///-///-/-/-///////-///-/////-///-/-///-///////-/////-///////-///-///-///-///
/-/-------/-/-------/-/-/-/---/---/-/-/-----/---/-----/---/-/---/---/-/---/-/---/-/-----/---/-/-/---/-----/-----/---/---/-/---/-----------/---/---/-/
/-///-/////-/-///////-/-/-/-/-/-/-/-/-/-/-/-/-///-///-///-/-/-///-///-/////-/-///-/-///-/-///-/-/-///////////////-/-/-///-/-///-///////////-///-///-/
/-----/-/-----/-------/---/-/-/-/---/---/-/-/---/---/-----/---/---/---/-----/-/---/-/---/-/-----/---------/-------/---/---/---/-----/-------/-/---/-/
///////-/-/////-/-/////-/////-/-/////-///-/-///-///-///////////-///-///-/////-/-///-///-/-/-///////////-/-/-/////////////-///-///////-///////-///-/-/
/-----/---/-----/-/-/---/-----/-----/-/-/-/-----/---/---/---/---/-/-/---/---/---/-----/-/-/-------/-----/---/-------/-----/---/-------/-/---/-----/-/
/-///-/-/////////-/-/-///-/////////-/-/-/-///////-///-/-/-/-/-///-/-/-///-///-///////-/-/-///////-/-///////////-/-/-/-/-///-///-///////-/-/-/-/////-/
/---/-/-/---------/---/---/-----/---/---/---/---/-/---/---/---/---/-/---/-/---/-------/---/-------/-/---------/-/-/---/-/---/-----/-/-----/---/-----/
/-/-/-/-/-/////////-///-/-/-/////-/////-///-/-/-/-/-///////////-///-/-/-/-/-///-///////////-///////-/-///////-///-///-///-///////-/-/-/////////////-/
/-/-/-/-/-----/---/-/---/-/---/---/-/-----/---/-/-/-/-----/---/-----/-/-/-/-/-----/-/-------/-------/-------/-----/---/---/-----/-/---/-------/-----/
///-///-/////-/-/-/-/-///-///-/-///-/-/////////-/-/-/-/-///-/-/-///////-/-/-/-///-/-/-/////////-/////-/////-///////-///-///-/-/-/-/-///////-/-/-/////
/---/---/-----/-/-/-/-/-/---/---/-------/-------/-/-/-/-/---/-/---/-----/-/-/-/---/---/---------/---/---/-/-------/-/---/---/-/---/-/-------/-/-----/
/-///-///-/////-///-/-/-///-/-///-///////-///////-/-/-///-///-///-/-/////-/-///-///-///-/////////-/-///-/-///////-///-///////-/////-///-/////-/////-/
/---/-/---/---/-----/-----/-/---/-/-------/-----/---/-/---/---/---/-/-------/---/-/-/-----/---/---/---/-/-------/-----/-------/-----/---/-----/---/-/
///-/-///-///-/-///////////-///-///-///////-/////////-/-///-/-/-///-/////-///-///-/-/////-/-/-/-///-///-///-///-///////-///////-/////-///-/////-/-/-/
/---/-/---/---/-/-----------/---/---/-----/---------/---/---/-/---/-----/-----/-/---/-----/-/-----/-/---/---/-/---/-----/-----/-/-----/-/-/-----/---/
/-///-/-///-///-///-/-///////-///-///-///-/-/////-///-///-///-///-/-///-///////-/-///-///////-/////-/-///-///-///-/-/-///////-/-///-///-/-/-///////-/
/-/---/---/-------/-/-/-----/---/-/---/-/-/-/---/-----/-/-/---/---/---/-/-----/-/-/---/-----/-/-----/-/---/---/---/-/-------/-------/-/---/-/-/-----/
/-/-///-/-///////-///-/-///-///-/-/-///-/-/-/-/////////-/-///-/-///////-/-/-/-/-/-///-/-/-/-///-///-/-///-/-/-/-///-///////-/////////-/-///-/-/-/////
/-/---/-/-------/-----/-/---/---/-/---/---/-/-/---------/---/-/---/-----/-/-/---/-/---/-/-/-----/---/-/---/-/-/---/---/---/-----/-----/-/---/-/-/---/
/-///-/-///////-/////////-///-///-/-/-/-///-/-/-/////-/-///-/-///-/-///////-/-///-/-/////-///////-///-/-///-/-///-///-/-/-/////-/-/////-/-/-/-/-/-///
/-----/-------/-------/---/---/---/-/-/-/---/---/---/-/-/-/-/-/---/-/-------/-/---/-/-----/-------/---/---/-/-----/-----/-/---/-/---/---/-/-/---/---/
/-///////-///////////-/-///-///-///-/-/-/-///-///-/-/-/-/-/-///-///-///-/////-/-///-/-/-///////-///-/////-/-///////////////-/-/-/-/-/-/////-/-/////-/
/-------/-/---/-------/-----/---/---/-/-/---/---/-/-/-/---/-/---/---/---/---/-/---/-/-/-------/-/---/-----/-/---/---/-------/---/-/-/---/---/---/---/
///////-///-/-/-///////-/////-///////-/////-///-/-/-/-///-/-/-///-///-///-/-/-///-/-///////-/-///-/////-///-/-/-/-/-/-///////////-/-///-/-/////-/-/-/
/-------/---/---/-----/-/---/-------/---/---/---/-/-/---/-/---/---/---/---/---/---/-------/-/-------/---/-/---/---/---/---------/-/-----/-/-/---/-/-/
/-///////-///////-/-///-/-/-/-/////-/-/-/-///-///-/-///-/-/////-///-///////-///-///-/////-/////////-/-///-///////////////-///////-///////-/-/-///-///
/-/---/---/-/---/-/-----/-/-----/---/-/-/---/---/-/---/-/---/---/-/-------/-/---/-------/-------/-/---/-------/---------/-----/---/-------/-/---/---/
/-/-/-/-///-/-/-/-///////-///////-///-/-///-///-/-/////-///-/-///-/-/////-///-///-/////////////-/-///////-///-///-/////-/////-/-/////////-/-///-///-/
/---/---/-/---/-/---/-----/---/---/-/-/-----/---/-----/-/---/-/---/---/-/-----/-----/---/-------/-------/---/-----/-/---/-----/---/-------/-----/---/
/////////-/-///-///-///////-/-/-///-/-///////-///////-/-///-/-/-/////-/-/////////-///-/-/-/////////-///-///-///////-/-///-///-///-/-///////-/////-/-/
/-/-----/---/-/-----/-------/---/---/-/-----/---/-----/---/-/-/-----/-/---------/-/---/---/-----/---/---/---/-/---/---/---/-/-/---/---/---/---/---/-/
/-/-///-/-///-///////-/////////////-/-/-///-///-/-///-///-/-/-///-///-/-///////-///-///////-///-/-///-///-///-/-/-/-///-///-/-/-///-/-/-/////-/-///-/
/---/-/-/-/-----/-----/---/---------/-/-/-/-----/-/-----/-/---/---/---/---/---/-/---/---/-----/---/---/---/-----/---/---/---/-/---/-/-/-/---/-/---/-/
/-///-/-/-/-/-/-/-///////-/-/////-///-/-/-///////-///////-/////-///-///-/-/-/-/-/-///-///-///-/////-///-/-///////-///-///-///-///-///-/-/-/-/-/-/-///
/-----/---/-/-/-/-/-/-----/-/---/-----/-/---------/-------/-----/---/---/---/-/---/---/---/-/-/-/---/---/-/-----/-----/---/---/---/---/---/---/-/---/
/////-///////-/-/-/-/-/-///-///-///////-///-///////-///////-/-///-///-///////-/////-///-///-/-/-/-///-///-/-///-///////-///-///-///-///-///////////-/
/-/---/-------/---/---/-----/---------/-----/-------/-----/-/-/---/---/-------/-----/---/---/-/-------/---/---/-------/-------/-/---/-------/-------/
/-/-///-///////////-/////////-///////-///////-///////-///-/-///-///////-///////-/////-/////-/-///-/////-/////-///////-///////-/-/-/-///////-///-///-/
/-/-/-/-----/-----/-/-------/---/-/---/-------/---/---/-----/---/-------/---/-------/---/---/---/-/---/-/-/---/-----/-------/-/-/-/-------/-----/---/
/-/-/-/-///-/-/-///-/-///-/-///-/-/-///-///////-/-/-///-/////-///-///////-/-/-/////-///-/-/-///-/-/-/-/-/-/-///-///-///////-///-/-///////-///////-///
/-/-/-----/-/-/-----/-/---/-----/---/---/-------/---/-/-/-/---/---/-/-----/-/-/---/-------/---/-/-/-/-/-/-/---/---/-------/-----/-----/---/-/-----/-/
/-/-///////-/-/////////-/////////-///-///-/-/////////-/-/-/-///-///-/-///-///-/-///////////////-/-/-/-/-/-///-///-///////-/////////////-///-/-/////-/
/---/-------/-/-----/---/-----/---/---/-/-/-------/-------/-/---/---/---/-----/---------/-------/-/-/-/---/---/---/---/---/---------/---/---/-/-----/
/-///-///////-///-/-/-///-/-///-///-///-/-///////-///////-/-///-/-/-///-/////////-///////-/////-///-/-///-/-///-///-/-/-///-/////-/-/-///-///-/-/////
/-/---/---/---/---/---/---/-/---/---/---/---/---/-------/-/-/---/-/-----/---------/-------/-----/---/---/-/---/---/-/-/---/---/---/---/-/-----/-----/
/-/-///-///-///-///////-///-/-///-///-/-///-/-/-///////-///-/-///-/////////-///-///-///////-/////-/////-/-///-///-/-/-///-/-///-///////-/-///////-/-/
/-/---/-/---/---/---/---/-/---/---/---/-----/-/-------/-----/---/-/-------/---/---/-/---------/---/---/-/-/---/---/-/-----/-/---/-------/-/-----/-/-/
/-///-/-/-///-///-/-/-///-///////-/-///////////////-/-/////////-/-/-/////-///////-/-/////-/////-///-/-/-///-///-///-/////////-///-/////-/-/-///-///-/
/-----/---/---/---/-/-/-----------/-/---/---/-------/---/---/---/-/-/-/---/---/---/-----/---/---/---/-/-/---/---/---/---------/-/-----/-/-/-/---/---/
///////-///-///-/-///-/////-///////-/-/-/-/-/-/////////-/-/-/-///-/-/-/-///-/-/-/-/////-/////-///-///-/-/-///-///-/////-///////-/-///-///-/-/-///-/1/
/-----------/---/-----------/---------/---/---/-----------/---/-----/-------/---/-----/-----------/---/-------/---------/-----------/-------/-----/2/
/////////////////////////////////////////////////////////////////////////////////////////////////////////////////////////////////////////////////////
