29 29
/////////////////////////////
/0--/---/-------------/-----/
/-/-///-/-///////-///-/-///-/
/-/---/---/-------/-/-/-/---/
/-///-/-///-///////-/-///-/-/
/---/-/-/---/---/-/---/---/-/
///-/-///-///-/-/-/-///-///-/
/-/-/-/-/-----/-/---/---/---/
/-/-/-/-///////-/-///-///-///
/---/---/-------/-/---/-/---/
/-///////-///////-/-///-///-/
/---/-----/-----/---/-------/
///-/-/////-/-///////-///////
/---/-/-/---/-------/-----/-/
/-///-/-/-///////-///////-/-/
/-/---/-/---/---/-/-------/-/
/-/-///-///-/-/-/-/-///////-/
/-/-/---/---/-/-/---/-------/
/-/-/-///-///-///////-/////-/
/-/-/-/---/---------/-----/-/
/-/-/-/-///////-///-/-///-///
/---/---/-------/---/---/---/
/////-///-///////-///-/////-/
/---/-/---/---/---/---/-----/
/-/-/-/-///-/-/-///////-///-/
/-/-/-/-/---/---/-------/-/-/
/-///-/-/-///////-///////-/1/
/-------/---------/--------2/
/////////////////////////////
