169 169
/////////////////////////////////////////////////////////////////////////////////////////////////////////////////////////////////////////////////////////////////////////
/0----/-----/---------/---/-------------/---------/---/---------------/---/---------------------/---------------------/---/-------------/-----------/---------/---------/
/-///-/-///-/////-///-/-/-/-///////-///-/////-///-/-/-///////-///////-/-/-///////////-///-/-/////-/////////////////-///-/-/-///////-///-/////-///////-///-///-/-/-/////-/
/-/---/-/-/-----/-/---/-/---------/---/-------/---/-/-----/---/-/-------/-/---/-----/---/-/-/---/-------/-------/---/---/-/-/-----/---/-----/-------/-/-/-/---/-/-----/-/
/-/-///-/-/////-/-/-///-///////////-/-/////-/////-/-/////-/-///-/-///////-/-/-/-///-/////-/-/-/-///////-/-/////-/-///-///-/-/-/-/////-/////-/-/////-/-/-/-/////-/////-///
/-/-/-/-/-----/-/-/---------/-----/-/-/-----/---/---/---/---/-----/---/-----/---/-------/-/-/-/-----/---/-/---/-/-------/-----/-/-----/-/---/-/---/-/---/-/-----/---/---/
/-/-/-/-/-/-///-/-/////////-/-///-/-/-/-/////-/-/////-/-///////////-/-/////////////////-/-///-/////-/-/////-/-/-/////////////////-/////-/-/////-/-/-///-/-/-///////-///-/
/-/---/-/-/-/---/---/-----/-/-/---/-/-/-----/-/-----/-/-------/---/-/-----------/---/-----/-------/-/-/-----/-/---/-----------/---/---/---/---/-/---/---/---/-------/---/
/-///////-/-/-/////-/-///-///-/-/////-///////-/////-/-///////-/-/-/-///////////-/-/-///////-///////-/-/-/////-///-/-/////////-/-///-/-/-///-/-/-/////-///////////-/-/-///
/-/---/---/-/-/---/-/-/-/-----/-----/-/---/---/---/---/-----/-/-/---/---/-----/---/-------/---/-----/-/-/---/-----/-----/-------/---/-/-----/---/-----/-----------/-/---/
/-/-/-/-///-/-/-/-/-/-/-///////////-/-/-/-/-///-/-/////-///-/-/-/////-/-/-///-///////////-///-/-/////-/-/-/-/////-/////-/-///////-///-///-/////-/-/////////-/-///-/////-/
/---/-/---/-/-/-/---/-/-/---------/-/---/-/-----/---/-/---/---/-/-----/---/-/-/-------/---/---/-----/---/-/-----/---/-/-/---/-----/---/---/---/-/---/-----/-/---/-/---/-/
/-///-/-///-/-/-/////-/-/-/-/////-/-///-/-/////////-/-///-///-/-/-/-///////-/-///-///-/-///-///////-/////-///-/////-/-/-/////-/////-///-///-/-/////-/-///-/////-///-/-/-/
/---/-/-/---/-/-----/-/---/-/-/---/---/-/---------/---/---/---/-/-/-/-/-----/---/-/---/-----/-----------/-/-/-----/---/-----/-----/-/-/-/-/-/-----/---/-/-/-----/---/---/
///-/-/-/-///-///////-/////-/-/-/////-///-///-/-/////-/-///////-/-/-/-/-///-///-/-///////////-///-/////-/-/-/////-///-/////-/-/////-/-/-/-/-///-///////-/-/-///-/-/////-/
/---/---/---/---------/-----/-/-/---/---/-/---/-/-----/---------/-/-/---/-/-----/---/---------/---/---/-/-/---/-/---/---/-/---/-----/-----/---/-/-------/-/-/---/-----/-/
///////////-///////////-/////-/-///-///-/-/-///-/-///////////////-/-/-///-/////////-/-/////////-///-/-/-/-/-/-/-///-///-/-/////-///-/////////-/-/-///-///-/-/////////-///
/-----------/-/---------/-/---/-------/-/-/-/---/---/-----/---/---/-/---/---------/-/---/-----/-/-/-/-/-/---/---/---/---/---/---/---/-----/---/---/-/-----/---------/---/
/-/////////-/-/-/////-///-/-/-///////-/-///-///////-/-///-/-/-/-///-///-/-/-/////-/-///-/-///-/-/-/-/-/////////-/-/-/-/////-/-///////-///-/-///////-///////////-/-/////-/
/-------/---/---/-----/-----/-------/-/---/-------/-/-/---/-/---/---/---/-/-----/---/---/-/---/-/-/-/-------/---/-/-/-/---/-/-------/---/-/-----/---------/-----/-/---/-/
/-/////-/-///-///-/////-///////////-/-///-/-///-///-/-/-///////-/-///-/////////-/////-/////-/-/-/-/-///-/-///-///-///-/-/-/-///////-///-/-/////-///-/////-/-///////-/-/-/
/-/-----/-/-/---/-/---/---/-----/-/-----/-/-/-/-----/-/---/---/-/-/-/-----------/-----/-----/-/-/-/---/-/-/-----/---/-/-/---/-----/-----/-----/---/---/-/-/-----/---/---/
/-/-/////-/-/-///-/-/-///-///-/-/-///////-/-/-///////-///-/-/-///-/-/////-/////-/-/////-/-/////-/-///-/-/-/-///////-/-/-/////-///-///////-///-///-/-/-/-/-/////-/-///////
/-/-/---/-/-/-/---/-/---/-----/-----/---/-/-/---/-----/-/---/-----/-----/-/---/-/---/---/-------/---/-/-/-/-/-/-----/-/-/-----/-/-----/---/---/---/-/-/-/-------/-/-----/
/-/-/-/-/-/-/-/-///-///-///////////-/-/-/-/-/-/-/////-/-///////////-/-///-/-/-/////-/////-///////-/-/-/-///-/-/-///-/-/-/-/////-///-/-/-///////-/////-/-///////-/-/-///-/
/-/-/-/-/-/---/-/---/-/---------/---/-/---/-/-/---/---/-/-------/---/-----/-/-/---/-----/---------/-/-/-/---/-/---/-/-/-/-----/---/-/-/---------/-----/-------/-/-/---/-/
///-/-/-/-/////-/-///-///////-///-///-/////-/-///-/-///-/-/////-/-/////////-/-/-/-/////-/////-///////-/-/-///-///-///-/-/////-/-/-/-///////////////-/-///////-/-/-///-/-/
/---/-/-/-/-----/-/---/-----/-----/---/---/---/-/-/-/---/---/-/---/---/-----/---/-/-----/---/-/-----/-/---/-----/-----/---------/-/-----/-----/-----/-/-----/---/-----/-/
/-///-/-/-/-/////-/-/-/-/-/////////-///-///////-/-/-/-/-///-/-///////-/-/////////-/-/////-/-///-///-/-///////-/-///////-/////////////-/-/-///-/-/-/////-///-///////-///-/
/-/---/-----/---/---/-/-/---------/---/-----/-----/-/-/---/-/---------/-/---/---/-/-/-----/-/---/---/-------/-/-/-----/-/-/---/-----/-/-/-/---/-/-----/-/---------/-/---/
/-///////////-///////-/-/////-///////-/-/-///-/////-/-///-/-/-///////-/-/-/-/-/-/-/-/-/////-/-///-/////////-/-/-///-///-/-/-/-/-///-/-/-///-///-/////-/-/////////-///-/-/
/-------/-----/---/---/-/-----/---/---/-/-/---/-----/---/-/---/-------/---/---/-/-/-----/-/-----/---------/-/-/---/-------/-/---/---/-/-----/---/---/-/-------/-------/-/
/-/////-///-/-/-/-/-/////-/////-/-/-/////-/-/////-///-///-/////-///////////////-/-/////-/-/////////-/////-/-/-///-///////-/-/////-///-/////-/-///-/-/-///////-/-///////-/
/-----/---/-/-/-/---/-----/---/-/---/-----/-/-----/---/-----/-/-/-/-------/---/-/-----/-----/---/---/-/---/-/---/-------/-/---/-----/-/---/-/-/---/-/---/---/-/-/-----/-/
/-///////-/-///-/////-/-///-/-/-///////-/-/-/-/-///////-///-/-/-/-/-///-/-/-/-/-/////-///////-/-/-///-/-///-/-/-///////-/////-/////-/-/-/-///-/-/-///-/-/-///-///-///-///
/-/-------/-------/---/-/---/---/-/-----/-/-/-/-/-----/-/-----/-/-/---/-/---/-/-/---/-------/-/-/---/-----/-/-/-/-----/-----/---/---/---/-------/-/---/---/---/-----/---/
///-/-///////////-///-///-///////-/-/-///-/-/-/-/-///-/-///////-/-/-///-///////-/-/////////-/-/-///-/-/////-/-/-/-///-/////-///-/-///////////////-/-/////-/-///-/////-/-/
/---/-/---/---/-/-----/---/---/-----/---/-/-/-/-/-/---/---/-----/---/---/-----/-/---------/---/---/-/---/---/-/-----/-/---/-----/---------/-----/-/---/-/-/---/-/---/-/-/
/-/-///-/-/-/-/-/////-/-///-/-/-///////-///-/-/-/-/-/////-/-/////-///-/-/-///-/-///-/-///////////-/-///-/-///////////-/-/-///////////////-/-///-/-///-/-/-///-/-/-/-///-/
/-/-/---/-/-/-/-----/-/-/-/-/---/-----/-----/-/-/-/-----/-/-----/-/-/-/-/---/-/---/-/-/-------/---/-/-/-/-----------/---/-/---/-------/-/---/-/-/---/-/---/---/-/-/-----/
/-/-/-///-/-/-/////-/-/-/-/-/////-///-///////-/-/-/////-/-/////-/-/-/-/////-/-///-///-/-/////-/-///-/-/-///////////-/////-/-/-/-///-/-/-/////-/-/////-/-///-/-/-/-/////-/
/-/-/---/-/-/-----/---/-/---/-----/-/---/-----/-/---/---/-----/-/---/-------/---/-/---/-/---/---/---/---/-------/---/-----/-/-----/-/-/-------/-------/-/---/-/-/-----/-/
/-/-///-/-/-/////-/-///-/-///////-/-///-/-///-/-///-/-///-/////-/////////////-///-/-/-/-/-/-/////-///////-///-///-///-/////////////-/-///-///-/////////-/-/////-/////-/-/
/-/---/-/---/-/---/-/---/-/-----/-/---/-/---/-/-/---/---/---------------------/---/-/-/-/-/-/-----/-----/-/-/-/---/-----------/---/-/-----/-----/-------/---/---/---/-/-/
/-/////-/////-/-/////-///-/-///-/-///-/-///-/-/-/-/////-///-/////////-/////-///-///-/-/-/-///-/-/-/-///-/-/-/-/-///-/////////-/-/-/-///////-/////-/////////-/-///-/-/-/-/
/-/---/-/-----/-------/-/---/-/-/-----/---/-/-/-/-/---/---/-/-------/-/---/-/---/---/-/-/-----/-/-/-/-/-/-/-/---/---/-------/---/-/-----/-----/---/-------/-/---/-/-/-/-/
/-/-/-/-/-///-/////////-/////-/-/////-///-/-/-/-/-/-/-///-/-/-/////-///-/-///-///-/////-/-/////-///-/-/-/-/-/////////-/////-///-/-///-/-///////-/////-/-/-/-///-/-/-/-/-/
/---/-/-/-/-/-----/-/-----/---/-/---/-/-/---/-/-/-/-/-/---/-/-----/-----/-----/---/-----/-/---/---/-/-/---/---------/---/-/---/-/---/-/---------/---/-/-/-/-/---/-/---/-/
/////-/-/-/-/-///-/-/-/-///-/-/-/-/-/-/-/////-/-/-/-///-///-/////-/////////////-/-/-/////-/-/-///-/-/-///////////-/-///-/-///-/////-/////-///////-/-///-///-/-///-/////-/
/-----/-/---/-/-/-/---/-----/---/-/-/-/-/-----/-/-/---/---/---/---/-/-------/---/---/---/---/---/---/-----/-----/-/-/---/---/---/---/---/-----/---/---/-/---/---/-/-----/
/-///-/-/////-/-/-/////////-///////-/-/-/-/////-/-///-///-/////-///-/-/////-/-///////-/-///////-/////-///-/-///-/-/-/-///-/////-/-/-/-/-/////-/-/////-/-/-/////-/-/////-/
/-/---/-------/-/-----/---/-/-------/---/---/---/---/-----/---/-/---/-----/---/---/---/-------/-/-----/-/-/---/---/-/-/-/-------/-/-/-/-----/---/-------/-------/-----/-/
/-/-///////////-/////-/-/-/-///-/-/////-///-///////-/////-/-/-/-///-/////-///////-/-/////-///-/-///-///-/-///-/////-/-/-/-///////-///-/////-/////////-///////////-///-/-/
/-/-----/-----------/-/-/-/---/-/-/-----/---/-----/-/---/---/-/---/-------/-/-----/-----/-/---/---/-/---/-----/---/---/---/---/-----/-----/-/-------/-/---------/---/-/-/
/-/////-/-///-/////-/-/-/-///-/-///-/////-///-///-/-/-/-/////-///-/-///////-/-/-/-/////-/-///////-/-///-///////-/-/////-///-/-///-/-///-///-/-/////-/-/-///////-/-///-/-/
/---/-/-/---/-----/-/-/-/-/-/-/-----/---/-----/---/---/-/---------/-----/---/-/-/-/-----/---/---/---/---/-----/-/-----/---/-/---/-/-----/---/-/-----/-/-/-------/-/---/-/
///-/-/-///////-/-///-/-/-/-/-///////-/-///-///-/-/////-///////////////-///-/-/-///-///////-/-/-/////-///-///-/-/-///-///-/-///-/////////-///-/-/////-/-///////-///-///-/
/---/---------/-/-/---/-/-/---/-------/---/-/---/-----/-----/-/-----/---/---/-/-----------/---/-----/---/-/-/---/---/---/---/-/---/-----/-/---/-/---/-/-/-----/---/---/-/
/-///////////-///-/-///-/-/-///-/////////-/-/-///////-/////-/-/-///-/-///-///-///////////////////-/-///-/-/-///////-/////////-///-/-///-/-/-///-/-///-/-/-///-///-///-/-/
/---/-----/-/-----/-/---/-/-/---/-------/-/-/---/---/---/-/-/-----/---/---/---/---/-------/-------/-----/---/-/-----/-----------/---/---/---/---/-----/-----/---/-----/-/
/-/-/-///-/-/////-/-/-///-/-///-/-/////-/-///-/-/-/-///-/-/-/-///////-/-///-///-/-/-/////-/-/-///////-/////-/-/-///-/-///////-/-/////-///////-/-///////////////-/////////
/-/-/-/---/-/-----/---/-/-/-----/-/-----/---/-/-/-/---/-/-/-/-/-/---/-/---------/-/-/---/---/-/---/---/---/-/-/-/-/-/-----/---/---/---/-------/-/-------/-----/-/-------/
/-/-/-/-///-/-/////////-/-///////-/-/-/////-///-///-/-/-/-/-/-/-/-/-/-///////////-/-/-/-///////-/-/-///-/-/-/-/-/-/-/////-/-/////-/-/////-/-/////-///-/-/-///-/-/-/////-/
/-/---/---/---/-----/-/---/-/-----/-/-/---/-/---/---/-/-/-/-/---/-/-/---/-----/-/-/---/-/-------/-/---/-/-/-/-/-/---/-/---/---/-/-/-/-----/-/-----/---/-/-/-/-/-/-/---/-/
///////-/-/-///-///-/-/-///-/-/////-///-/-/-/-///-/-///-/-/-/////-/-///-/-///-/-/-/////-/-///////-///-/-/-/-/-/-///-/-/-/////-/-/-/-///-/////-/////-///-/-/-/-/-/-/-///-/
/-----/-/-/-/---/-----/---/-/-/---/---/-/---/---/-/-/-----/-/---/-/-/-/-/-/-/-/-/---/-/-/---/---/---/-/-/-/-/-/---/---/-----/-/---/---/-------/-----/-/-/-/-----/-/-/---/
/-///-///-/-/-/////-/////-/-/-/-/-///-/-///////-/-///-/////-/-/-/-/-/-/-/-/-/-/-///-/-/-///-///-///-///-/-/-/-///-///-/////-/-///////-/////-///-/////-/-/-/////-/-/-/-///
/-/---/---/-/-/---/-/-----/-/-/-/---/---/---/---/---/-/-/---/-/---/-/-/-/-/-/-/---/-/-/---/-------/---/-/---/---/---/-----/-/-----/---/---/---/-/-/-----/-----/-/-/-/---/
/-/-///-///-/-/-/-///-/////-/-/-///-/////-/-/-/////-/-/-/-/-/-/////-/-/-/-/-/-/-/-/-/-///-///////-///-/-///////-///-///-///-/////-/-///-/-/////-/-/-/////////-///-/-///-/
/-/-----/---/-/-/---/---/-----/-/-/-------/---/-----/-/-/-/-/-/---/-/-----/---/-/-------/-------/---/---------/-/---/-/-/---/---/-/-----/-/-----/-/---/---/---/---/-/---/
/-///////-///-/-///-///-///-///-/-/////////////-/////-/-/-/-/-/-/-/-///////-///////////-///-///-///-/////////-/-/-///-/-/-///-/-/-///////-/-/////-///-/-/-/-/-/-///-/-///
/-------/-/-----/---/-/---/-----/-------/-------/---/-/-/-/-/---/-/-------/---------/---/---/-----/---/---/---/-/---/---/-/---/-/---/-----/---/---/---/-/---/-/-----/---/
/////-/-/-///-///-/-/-///-///////-/-///-/-/////-/-/-/-/-/-///////-///////-/////////-/-///-///-/////-///-/-///-/-///-///-/-/-///-///-/-///////-/-/-/-///-///////////-///-/
/---/-/-/---/-/---/-----/-/-------/---/---/-----/-/-/-/-/---/---/-/-----/-/---/-----/-/-/---/-/-----/---/---/-----/---/-/-/-/-----/-/-/-----/-/-/-/-/-/-----/-----/---/-/
/-/-///-///-///-///////-/-///-///////-/////-/////-/-/-/-///-/-/-/-/////-/-/-/-/-/////-/-///-/-/-/////-/////-///-/////-/-/-/-/////-/-/-/-///-/-/-///-/-/////-/-/-/-///-/-/
/-/-----/-----/-/-----/-/---/---/---/-/---/-/-----/---/---/---/---------/-/-/-/-----/---/---/-/-/---/-/---/---/-/-----/-/-/-----/-/---/-/-----/-------/---/---/-/-/---/-/
/-///////////-/-/-///-/-///-/////-/-/-/-///-/-/////////-/////////////////-/-/-/////-///-/-///-/-///-/-/-/-///-///-/-/////-/-///-///////-/-/////-///////-/-/////-///-///-/
/-/---------/---/---/-/---/-/---/-/-/-/-----/---/---/-----/---------------/-/---/---/---/-/---/---/-/---/---/---/-/-/-----/---/-/-------/-/---/-----/---/-----/-/---/---/
/-/-///////-/-/////-/-///-/-/-/-/-/-/-/-///////-/-/-/////-/-///////////////-/////-/////-/-///-///-/-///////-///-/-/-/-/////////-/-/////-///-/-///////-///-///-/-/-///-/-/
/-----/-----/-/---/-/---/-/---/-/-/-/-/-----/-/---/-------/-/-------/-----------/-/---/-/---/---/-----/---/---/---/-/---------/-/-----/-----/---------/---/---/---/---/-/
/-/////-/////-/-/-/-///-///////-/-/-/-/////-/-///////////-/-///-/-/-/-/////////-/-/-/-/-///-/////////-/-/-///-///////////////-/-///-/////-///////-/////-/-/////-///-/////
/---/---/-----/-/-/-/-/-/-----/-/-/-/-/-/-----/---------/-/---/-/-/-/-/---/---/-/---/-/---/---------/-/-/---/---------------/-/-----/---/-/-----/---/---/-/---/-/---/---/
///-/-///-/////-/-/-/-/-/-/-///-/-/-/-/-/-/////-/////-///-///-///-/-/-/-/-/-/-/-/////-///-///////-/-/-/////-///////////////-/-/-/////-/-///-///-/////-/////-/-/-/-///-/-/
/-/-/-/-------/-/-/---/---/-/---/-/---/-/---/---/-/---/-----/---/-/-/---/-/-/-/-/-----/---/---/-/-/-/-/-------/---------/---/-/-/-----/-----/---/-----/-----/-/-/-----/-/
/-/-/-/-///////-/-///-/////-/-///-/////-///-/-///-/-///-///////-/-/-/////-///-/-/-/////-///-/-/-/-///-/-/////-///-///////-///-///-///////////-///-///-/-/////-/-///////-/
/---/-/-/-------/-----/-/---/---/-----/-----/-/---/-------/-----/-/-/-----/---/-/---/---/---/-/-/-/---/---/---/---/-----/---/-----/-/-------/-/---/---/-/-----/-------/-/
/-///-/-/-/////////////-/-/////-/////-///-///-/-///////////-/////-///-/////-///-///-///-/-///-/-/-/-/////-/-///-///-///-///-///////-/-/-///-/-///-/////-/-/////-///////-/
/-/---/-/---------------/-----/-----/---/-/-/-/---------/---/---/-----/-/-----/---/---/---/-/---/---/-----/-/---/---/---------------/-/---/-/-----/-----/-----/-/-----/-/
///-///-///////////////-/////-/////-/-/-/-/-/-///-/////-/-///-/-/-/////-/-///-///-///-/////-///-/////-/////-/-/-/-/////////////////-/-///-///////-/-/////////-///-///-/-/
/---/-----/-------/-/-----/-------/-/-/-/---/-/---/-/---/-/---/-/-/---/---/---/-/---/-/-------/-/-----/-----/-/-/---------/---/-----/---/-/-----/-/-/-/-----/-/---/-/---/
/-///////-/////-/-/-/-/////-///////-/-/-/////-/-///-/-///-/////-/-///-/-///-/-/-///-/-/-/-/////-/-/-///-///////-/////////-/-/-/-///////-/-/-///-/-/-/-/-///-/-/-///-///-/
/-----/---------/---/-/-/---/-------/-/---------/-------/-/-----/-/---/---/-/---/-/---/-/-----/-/-/-/-/---------/-------/-/-/-------/---/-/---/---/-/-----/-----/---/---/
/-///-/////////////-/-/-/-///-/////////-/////////////////-/-/////-/-/-///-/-///-/-/////-/////-/-/-/-/-/////////-/-/////-/-/-/////////-///-///-/////-///////////////-/-///
/---/---/-/-----/---/-/-/-----/-------/---/---------------/-/-----/-/---/-/---/-------/-/---/---/-/-/---------/---/---/-/-/-----/---/---/---/---/---/-------------/-/-/-/
///-///-/-/-/-///-///-/-/////////-///-/////-///////////////-/-/////-/////-///-///////-/-/-/////////-/-/-///////////-///-/-///////-/-///-///-/-///-/-/-///////////-/-/-/-/
/-/-/-/-/-/-/---/---/---/---------/-/-------/-/---------/---/---/---/-----/-/-/---/---/-/-/---------/-/-------------/---/-/-------/---/-/-/---/---/-/---------/---/---/-/
/-/-/-/-/-/-///-///-///-///-///////-/////////-/-///////-/-/-///-///-/-/////-/-/-/-/-///-/-/-/-/-///////-///////-///-/-///-/-/////////-/-/-/////-///-///-///////-/////-/-/
/---/-/-/---/-----/-/-/---/-/-------/---------/---/---/---/---/---/-/-----/-/---/-/---/-/---/-/-/-----/---/---/---/-/-/-/---/-------/---/---/---/-/-/-/-/---/---/---/---/
/-///-/-/////-/////-/-///-/-/-/////-///////-/////-/-///////-/////-/-/////-/-/////-///-/-/////-///-///-///-/-/////-///-/-/////-///-/////////-/-///-/-/-/-/-/-/-///-/-/////
/---/-/-----/---/---/---/---/-/---/---------/-----/-------/-------/---/---/---/-/---/-/-----/---/---/-/-/-/-----/-----/-/---/-/-/-----------/-/-------/-/-/---/---/-----/
///-/-/////-///-/-/////-/////-/-/-/////////-/-///////////-/////////-/-/-///-/-/-///-///////-/-/-/-///-/-/-/////-///////-/-/-/-/-/////-///////-/-///////-/-/////-///////-/
/---------/-/---/-/---/---/---/-/---------/-/-/---/-------/---------/-/-/---/---/---/-----/-/-/---/---/-/-/---/---/-----/-/---/-/-----/-------/-/-------/-----------/---/
/-/////////-/-///-/-/-/-/-/-///-/-///////-/-/-/-/-/-/////-/-/////-/-///-/-/////-/-///-///-/-///////-///-/-/-/-///-/-/-/-/-/////-/-/-///-///////-/-///////////////////-///
/-/---------/---/-/-/-/-/-/-/---/-------/-/-/---/---/---/-/-/-----/-/---/---/---/-----/---/---------/---/---/---/---/-/-/---/---/-/-/---/-/-----/-------/-----/-----/---/
/-/-/////////-/-/-/-/-/-/-/-/-/////////-/-/-/////////-/-/-///-/////-/-///-/-/-/////////-/////////////-/-///////-/////-/-///-///-/-///-///-/-///////////-/////-/-///-///-/
/-/-/---------/-/---/---/---/---/-----/-/-/---/-----/-/-/---/-----/-/---/-/-/-/-------/-----------/---/-----/---/-----/-/-------/---/---/-----/-------/-----/-/---/-----/
/-/-///////////-///////////////-/-///-/-/////-/-/-///-/-///-/////-/////-/-/-///-/-///-///-///////-/////////-/-///-/-/////-/////////-///-/-/////-/-/-///////-/-///-/////-/
/-/-/-------/---------/---/---/-/-/---/-----/---/-/---/---/-----/-----/-/-/-----/---/-/-/-------/-----------/-/---/-/-----/-------/-/---/-/-----/-/-/---------/---/-/---/
/-/-/-/////-/-///////-/-/-/-/-/-/-/-///////-///-///-/////-/////-/-/-///-///////////-/-/-///////-///////-/////-/-/-/-/-/////-/////-/-/-/////-/////-/-/-/////////-///-/-///
/-/-----/---/-------/---/-/-/-/-/-/-/---/-/---/-/---/---/---/---/-/---/---/---/-----/-------/-/-----/---/-----/-/-/-/-/-/---/---/-/-/-------/-/---/-/-/---/-----/-/---/-/
/////////-///-/////-///////-/-/-/-/-/-/-/-/-///-/-/////-/-///-///-///-///-/-/-/-/-/////////-/-/////-/////-///////-///-/-/-/////-/-/-/////////-/-/-///-/-/-/-/////-/-///-/
/---/---/-/---/---/---/-----/-/---/---/-/-/-----/-/-----/-----/---/-/-----/-/---/-/-----/-/---/---/-------------/-------/---/---/-/-------/---/-/-/---/-/---/-----/-----/
/-/-/-/-/-/-///-/-///-/-/////-/////////-/-///////-///-/-///////-///-///////-///////-///-/-///-///-/////////////-///////////-/-///-///-///-/-/-/-/-/-///-/////-/-///////-/
/-/---/---/---/-/---/---/---/---------/---/-/-----/---/-/-----/-/-------------------/---/-/---/---/-----/---/-----------/---/---/---/---/---/-/-/-/---/-/---/-/-----/---/
/-///////////-/-///-/-///-/-///-/-///////-/-/-/////-///-/-/-///-///////////////-/////-///-/-///-/-/////-/-/-///////////-/-/////-///-/-/-///-///-/////-/-/-/-/-///-///-///
/---/---------/-/---/-/---/-/---/-/-------/-/-/-----/---/-/-----/-------/-----/---/---/---/-/---/-------/-/---------/-/---/-----/---/-/-/---/---/-----/-/-/-----/-/---/-/
/-/-///////////-/-///-/-///-/-/////-///////-/-/////-/-/////////-/-/////-/-///-/////-///-/-/-/-/////////-/-/-///////-/-/////-///-/-/////-/////-///-/////-/-///////-/-///-/
/-/-----/-------/-/-----/-/-/-/-----/-------/---/---/---/-----/---/---/---/-/---/---/---/-/---/---/-----/-/-/-----/-/-------/---/-----/-----/-----/-----/-/-------/-/---/
/-/////-/-///////-///////-/-/-/-/////-/////-///-/-/////-/-///-///////-/////-///-/-/////-/-///////-/-/////-///-///-/-/////-/-/////////-/////-///////-/////-/-///////-/-///
/-/-----/-------/-------/-/-/-/-------/-----/-/---/---/---/---/---------/-----/---/-----/---/-----/---/---/---/-/-/-----/-/-/-------/-/-------/---/---/---/---------/---/
/-/-///////////-///////-/-/-/-/////////-/////-/////-///////-///-/-///-///-///-/////-/-///////-/-/////-/-///-///-/-/////-///-/-/-/////-/-/////-///-///-/-///////////////-/
/-/-----------/---/-/---/---/---------/-/-----------/-------/---/-/-/-/---/-----/---/-/---/---/-----/-/---/-/---/-/---/---/-/-/---/---/---/---------/-/---/---/---------/
/-///////////-///-/-/-/////-/////////-/-/////-/-///-/-///////////-/-/-/-///-///-///-///-/-/-///////-/-///-/-/-/-/-/-/-///-/-/-///-/-/////-/-///////-/-///-/-///-/////-///
/---/-------/-----/-/-----/---/-----/-/-/---/-/-/---/-------/-----/---/-/---/-/-/---/---/---/-----/-----/---/-/-/-/-/-/---/---/-/-/-/-----/-/-----/-/-/-/-/---------/---/
///-/////-/-///////-/////-///-/-///-/-/-/-/-///-/-/////////-/-/////////-/-///-/-/-/-/-///////-/-///////////-/-/-/-///-/-/////-/-/-/-/-///////-///-/-/-/-/-/////////////-/
/-/-----/-/-----/---/-----/-/-/---/-/-/-/-/-----/-----/-----/-----/-----/-/---/-/-/-/-----/---/-----/-----/---/-/---/-/-/---/---/---/---/---/-/---/-/-/---------/-------/
/-/////-/-///-/-///-/-/////-/-///-///-/-/-///////////-/-/////-///-/-/////-/-/-/-/-///////-/-/////-///-///-/////////-/-/-/-/-///-///////-/-/-/-/-///-/-/////////-/-///////
/---/---/---/-/-----/-----/-/-----/---/---/-----/-----/-----/---/---/-/---/-/-/---/-----/-/-/-----/---/-/---/---/---/-/---/---/---------/-/---/-/-/-/-/---/-/---/-/-----/
/-/-/-///////-///-///////-/-/////-/-/-///-/-///-/////-/////-///////-/-/-///-/-///-/-///-/-///-///-/-///-///-/-/-/-///-///////-/////////-/-/////-/-/-/-/-/-/-/-///-/-///-/
/-/---/-------/---/-----/-/-------/-/-/---/---/-/---/-/---/-------/-/-/-/---/---/-/-/---/-/---/---/-/-----/---/---/---------/-/-------/-/-/---/-/---/---/-/-/-/-----/---/
/-/////-///////-///-///-/-/////////-///-/////-/-/-/-///-/-///////-/-/-/-/////-///-/-/-///-/-///////-/-/////////////-///////-/-///-/-///-/-/-/-/-/-///////-/-/-///////-/-/
/-------/-----/---/-/-----/-------/-/-------/-/-/-/-/---/-------/-/---/-----/-----/-/-------/-----/-/-------------/-/-/---/-/---/-/-/---/-/-/---/-------/-/-/---------/-/
/////////-/////-///-///////-/////-/-/-///////-/-/-/-/-/////-/////-///-/////-/-/////-/////////-///-/-/-/////-///////-/-/-/-/-///-///-/-///-/-/////////////-/-///////-/////
/-----/---/-----/---/-------/-----/---/-/-----/---/---/---/-----/---/---/---/-----/-/---/-----/-----/-----/-/---------/-/-----/---/-----/-/---/---------/-/---------/---/
/-/-///-/-/-/////-/-/-///////-/////-///-/-/////////////-/-/////-///-/////-/////////-/-///-/////////////////-/-/////////-/////-///-/////-/-///-///-/////-/-///////////-/-/
/-/-----/---/-----/-/-----/---/---/-----/-------/-----/-/-/-----/---/-----/---/-----/-/---/-----/---------/-/-/-----/---/-------/---/---/-/-/---/-/-----/---/---/-----/-/
/-///////////-/////-/////-/-///-/-///-/////////-///-///-/-/-/////-///-/////-/-/-/////-/-///-///-///-/////-/-/-/////-/-/////////-///-/////-/-///-/-/-/////-/-/-/-/-/////-/
/-/-------/---/---/-/---/-/-----/---/-/-------/---/-----/-/-------/-/-----/-/---/---/-/-----/-/---/-/-------/-/---/-/-/-------/-/-/-------/---/---/-----/-/---/---/-/---/
/-/-/-///-/-/////-/-/-///-/////////-///-///-/////-///////-/////////-/-///-/-/////-/-/-///////-///-/-///////-/-/-/-/-/-/-/////-/-/-/////////-/-/////////-/-/////////-/-///
/-/-/-/-/-/-/---/-----/---/---/---/-------/-/---/-/---/-----/---/---/-/-/-/-------/---/-----/-/---/-----/---/---/---/-----/---/---/---/-----/-/-----/---/-----/-----/---/
/-///-/-/-/-/-/-/////-/-///-/-/-/-/////////-/-/-/-/-/-/-///-/-/-/-///-/-/-/-/////////-/-///-/-/-///-///-///////////-///////-/////-/-/-/////-/-/-///-/-///////-/-///////-/
/-----/---/-/-/-----/-/-----/---/-----/-----/-/-/---/---/---/-/-/-------/---/-----/-----/-----/-/-/---/-------------/-/-----/---/---/-/-----/---/-/-/-/-----/---/-------/
///////-///-/-/////-/-/////////////-///-/////-/-/////////-///-/-///////////-/-///-/////////////-/-///-///////////////-/-/////-/-/////-/-/////////-/-/-///-/-///-/-/////-/
/-----/---/-/-----/-/-----/-------/-/---/-----/---/-----/-/---/-----------/-/-/-/---------------/-----/---/---------/-/-----/-/---/---/---/---------/-----/-/---/-----/-/
/-///-/-///-/////-/-///////-/////-/-/-///-/////-/-/////-/-///-///////////-/-/-/-/////-///////////-/////-/-/-/////-/-/-/////-///-///-/////-/-///////////////-/-///////-/-/
/-/-/-/-/---/-----/-------/-----/---/-----/-----/-------/---/-------/---/-/-/-/-------/---/-----/-/---/-/---/-----/-------/---/-/---/-----/---/---------/---/-/-----/-/-/
/-/-/-/-/-///-///////////-/-///////-///////-///////////-///-///-///-/-///-///-/////////-/-/-///-/-/-/-/-/////-///////////-///-/-/-///-/-/////-/-///////-/-/////-///-/-///
/-/-/---/---/---/-------/---/-----/-------/-/-------------/---/-/---/---/---/---/---/---/-/---/-/-/-/-----/---/-/-----------/-/-/-/---/-/---/-/-----/-/---/-----/---/---/
/-/-///////-///-/-///-/-/////-///-/////////-///-/////////////-///-///-/-///-///-/-/-/-///-/-/-///-/-///////-///-/-///////////-/-/-/-///-/-/-/-/////-/-/////-/////-/////-/
/-------/-----/-/-/---/-/-----/-----------/---/-/---/-/-----/---/-/---/---/-/---/-/---/---/-/---/-/---/-----/-/---/---/-------/---/-/---/-/-/---/-/---/-----/-/---/-----/
/////-///-///-/-///-/////-///-///////////-///-/-/-/-/-/-/-/-///-/-/-/////-/-/-///-/////-///////-/-///-/-/////-/-///-/-/-///////-/////-///-/-///-/-///-/////-/-/-/////-/-/
/-----/---/---/-----/-----/---/-------/---/---/---/---/-/-/---/---/-/-----/-/-----/---/-------/-/-/---/-/-----/---/-/-/-/-----/-----/---/-/---/---/---/---/-/---/-----/-/
/-/////-///////////-/-/-///////-/////-///-/-/-/////////-/-///-/////-/-///-/-/////-///-///////-/-/-/-///-/-/-/////-/-/-/-/////-/////-///-/-/-///-///-///-/-/-/-///-///////
/---/-/---------/---/-/-/-----/-/---/---/---/-/---/---/-/---/-/-/---/---/-/-----/-----/-/-----/---/---/-/-/-/---/-/-/---/-----/---/-----/-/-----/---/---/---/-/---------/
///-/-///////-/-/-///-/-/-///-/-///-///-///////-/-/-/-/-///-/-/-/-/////-///////-/////-/-/-/////-///////-/-///-/-/-/-/////-///-/-/-///////-///////-/////-/////-/-///////-/
/---/-------/-/-/-/---/-/---/-/---/---/-/-------/---/---/---/---/-/-----/---/---/-------/-----/-/-------/-/---/---/---/---/---/-/---/---/-/-----/-/-----/---/-/---/-----/
/-///////-/-/-///-/-///-/-///-///-///-/-/-///////////////-///////-/-/-///-/-/-///-///////////-/-/-///////-/-/////////-/-/-///-/-///-/-/-/-/////-/-/-/-/////-/-/////-///-/
/---------/-/-----/-/-/-/-/-----/-/---/---/---/---------/---------/-/-/---/---/-----/-----/---/---/-------/-/---------/-/---/-/---/-/-/-/-------/-/-/-----/-/-----/-/---/
///////////-///////-/-/-/-/-///-/-/-/-///////-/-/////-/-///////////-///-///////-/////-///-/-///////-///-///-/-/////////////-/-/////-/-/-///////-/-/-/////-/-/////-/-///-/
/-----/-----/-/-----/---/-/---/-/-/-/---------/-/---/-/-/-------/---/---/-----/---/---/-/-/-/-----/-/-/-/---/-/-----/-------/-------/-/-/---/---/-/---/---/-----/-/---/-/
/-///-/-/////-/-/////-///-///-///-/-///////////-/-/-/-///-/////-/-///-///////-///-/-///-/-/-/-///-/-/-/-/-///-///-///-/-/////////////-/-/-/-/-///-///-/-///-/-///-/-/-///
/-/---/-/-----/---/-----/-/-/-/---/-/-----------/-/-/---/-----/-/---/-------/-----/---/---/-/---/---/-/-/-/-/---/---/-/---------/-----/---/-----/-/---/-/---/-/---/-/---/
/-/////-///-/////-/-/////-/-/-/-///-/-///////////-/-///-/-/////-///-///////-/////////-/-///-///-/////-/-/-/-///-/-/-/-/////////-/-///////////-///-/-///-/-/////-///-///-/
/-----/---/-/---/-/---/---/-/---/-------------/---/---/---/---/-/---/-----/---------/-/---/---/---/---/-/-/---/-/-/---------/-/---------/---/-/---/-/---/-------/-----/-/
/////-///-/-/-/-/-/////-///-/////-/////////////-/////-/////-/-/-/-///-/-/-/////////-/-///-/-/-///-/-/-/-/-/-///-///////////-/-///////////-/-///-///-/-///////-/////-///-/
/-------/-/---/-/-----/-/-----/---/---/---/---/---/---/---/-/---/-/---/-/---/-----/---/---/-/-/-/-/-/-/-/-/---/-------/-------/-----------/---/-/---/-------/-----/-/---/
/-///////-/////-/////-/-/-///-/////-/-/-/-/-/-///-/-///-/-/-///-/-/-///-/////-/-///////-/////-/-/-/-/-/-/-///-///////-/////////-/////////////-/-///////////-/////-///-/1/
/-------------------/-----/---------/---/---/-----/-----/---/---/-----/-------/---------------/-----/-/-------------/-----------------------/---------------/---------/2/
/////////////////////////////////////////////////////////////////////////////////////////////////////////////////////////////////////////////////////////////////////////
