49 49
/////////////////////////////////////////////////
/0----/-----------/-------/---------/-----/-----/
/-///-///-///////-/////-/-/-///////-/-/-/-/-///-/
/---/-----/---/---/-----/---/---/---/-/-/---/-/-/
///-///////-///-///-/////////-/-/-///-/-/////-/-/
/-/-------/-/---/---/---------/-/-/-/-/-/-----/-/
/-///////-/-/-///-///-/-///////-/-/-/-/-/////-/-/
/-----/---/---/-----/-/-------/-/-/---/-----/---/
/-/////////-/////-/-/-///////-///-/-///////-/-///
/---------/-----/-/-/---/---/-----/-/-------/-/-/
/////-///-/////-/-/-///-/-/-/////////-///////-/-/
/-----/-----/---/-/-/-----/-----/-----/-----/-/-/
/-/////-/////-///-/-///////////-/-/////-/-///-/-/
/-/-------/---/---/---/-/-------/-/-/---/-/---/-/
/-/////-///-///////-/-/-/-///////-/-/-///-/-///-/
/-----/-/---/-----/-/-/---/-------/---/-/-/-/---/
/-///-/-/-///-/-/-///-/-///-///////-///-/-/-/-/-/
/-/---/-/---/-/-/-----/-/-/-------/-----/-/-/-/-/
///-///-///-///-///////-/-/-/////-///////-/-///-/
/---/---/---/---/-------/---/---/-------/---/---/
/-///-///-///-///-///////-/////-///////-/-///-/-/
/-/-----/-/---/---/-----/-/---/-----/---/-/---/-/
/-/////-/-///-/-///-/-///-/-/-/-/-///-///-/-/////
/-----/-/-/---/---/-/-----/-/---/-/---/-/-/-----/
/-///-///-/-/////-/-///////-///////-///-/-/-///-/
/-/-/-----/-/-/---/-/-------/-------/-----/-/---/
/-/-///////-/-/-///-/-///////-///////-///////-/-/
/-/---/---/-/-/---/---/-------/-----/-/-----/-/-/
/-/-/-/-/-/-/-///-/////-///////-/-///-/-/-/-/-/-/
/---/---/---/-/---/-----/---/---/-----/-/-/-/-/-/
/////////////-/-///-/////-///-///////////-/-/-/-/
/-----/-------/---/-/-/---/---/-----------/---/-/
/-///-/-/////-///-/-/-/-/-/-///////-///////////-/
/---/-/-/---/-----/-/---/-/---/-----/---------/-/
/-/-///-/-/////////-///-/-///-/-/////-///////-/-/
/-/-----/-----/-/-----/-/-----/-/-/---/-----/-/-/
/-/////////-/-/-/-///-/-///////-/-/-///////-/-/-/
/---/-------/-/-----/-/-/-------/-/---/-----/---/
///-/-///////-///////-/-/-///////-///-/-///-/////
/---/-/---/---/-------/-/-----/-------/-/-----/-/
/-///-/-/-/-///-///////-/-///-/-///////-/////-/-/
/---/---/-/-/---/---/---/-/---/---/-------/-----/
///-/////-/-/-///-/-/-/////-/////-/-/////-///////
/---/-----/-/-----/-/---/---/-----/-----/-------/
/-///-/////-///////-///-/-///////-/-///////////-/
/---/-/-----/-------/---/-------/-/-/---/-------/
///-/-/-/////-///////-/////////-/-///-/-/-/////-/
/-----/-------/-----------------/-----/---/21---/
/////////////////////////////////////////////////
