6 24
////////////////////////
/---------------------2/
/-//-///////////////////
/--------------------10/
/----------------------/
////////////////////////