6 9
/////////
///--////
/-----1-/
/-/--/1-/
/-2-2/0-/
/////////