7 8
////////
/--/---/
/-1221-/
/0123-//
/-1221-/
/--/---/
////////
