11 9
/////////
/---0---/
/-11111-/
/-------/
/-11111-/
/-------/
/-------/
/-2-2-2-/
/2-2-2-2/
/-2-2-2-/
/////////