5 11
///////////
/---202---/
/-/1/1/1/-/
/----2----/
///////////
